#############################
#                           #
# ##### #    # ######   #   #
# #P  # #    #   #     # #  #
# #   # #   ##   #    #   # #
# ##### #  # #   #    ##### #
# #     # #  #   #    #   # #
# #     ##   #   #    #   # #
# #     #    #   #    #   # #
#                           #
#############################