#####
#E  #
#   #
# P #
#####